--PPPPPPPPPPP--
---PPPPPPPPP---
----PPPPPPP----
-----PPPPP-----
VVVVVVPPP------
VVVVVVVP-------
VVVVVVVV------V