--PPPPPPPPPPP--
---PPPPPPPPP---
----PPPPPPP----
-----PPPPP-----
~~~~~~PPP------
~~~~~~~P-------
~~~~~~~~------~